NO ./xpm/no.xpm
SO ./xpm/so.xpm
WE ./xpm/we.xpm
EA ./xpm/ea.xpm

F 88,100,0
C 12,12,12

1111111111111111111111111
1000000N00000000000000001
1111000000000000000001111
1000000000000000000000001
