NO ./xpm/no.xpm
SO ./xpm/so.xpm
WE ./xpm/we.xpm
EA ./xpm/ea.xpm

F 220,100,100
C 225,30,0

        1111111111111111111111111
        1000000000110000000000001
        1011000001110000000000001
        100100000000000000Q000001
111111111011000001110000000000001
10000000001100E001110111111111111
1100000000000000000000000000011111111
111111111111111111111111111111111