NO ../xpm/no.xpm
SO ../xpm/so.xpm
WE ../xpm/we.xpm
EA ../xpm/ea.xpm

F 220,100,0
C 225,30,0

        1111111111111111111111111
        1000000000110000001000001
        1011000001110000001000001
        1001000000000000001000001
111111111011000001110000001000001
100000000011000001110111101011111
11110111111111011100000010101
11110111111111011101010010101
11000000110101011100000010101
10000000000000001100000010101
10000000000000001100000010101
10000000000000001100000010101
10000000000000001100000010101
10000000000000001100000010101
10000000000000001100000010001
10000N00000000001100000010001
10000000000000001100000010001
10000000000000001100000010001
10000000000000001101010010001
1100000111010101111101111000111
11110111 1110101 101111010001
11111111 1111111 111111111111