NO ./xpm/no.xpm
SO ./xpm/so.xpm
WE ./xpm/we.xpm
EA ./xpm/ea.xpm
DO ./xpm/door.xpm
OD ./xpm/o_door.xpm

F 220,100,0
C 225,30,0

1111111111111111111111111
1000000000000000000000001
1111000000000000000001111
1000000000000000000000001
1000000000000000000000001
1000000222220000000000001
1000000200020000000000001
1000000200020000000000001
1000000200020000000001111
1000000222220000000000001
1000000000000000000001111
100000000000000000W000001
1111111111111111111111111