NO ../xpm/no.xpm
SO ../xpm/so.xpm
WE ../xpm/we.xpm
EA ../xpm/ea.xpm

F 220,100,0
C 225,30,0

1111111111111111111111111
1000000000000000000000001
1111000000000000000001111
1000000000000000000000001
1000000000000000000000001
1000000000000000000000001
1000000000000000000000001
1000000000000000000000001
1000000000000000000000001
1000000000000000000000001
1000000000000000000000001
10000000000N0000000000001
1111111111111111111111111

empty line handle?