NO ./xpm/no.xpm
SO ./xpm/so.xpm
WE ./xpm/we.xpm
EA ./xpm/ea.xpm
DO ./xpm/cl_door.xpm
OD ./xpm/o_door.xpm

F 220,100,0
C 225,30,0

1111111111111111111111111
1000000000000000000000001
1111000000000000000001111
1000000000000000000000001
1000000000000000000000001
1000000112110000000000001
1000000100010000000000001
1000000200020000000000001
1000000100010000000001111
1000000112110000000000001
1000000000000000000001111
1000000000000000000000001
100000000N000000000000001
1111111111111111111111111
