    NO ./xpm/no.xpm
    SO ./xpm/so.xpm
WE ./xpm/we.xpm
EA ./xpm/ea.xpm

  F 33,33,99
            C 12,12,12

1111111111111111111111111
1000000000000000000000001
1111000000000000000001111
1000000000000000000000001
1000000000000000000000001
1000000111210000000000001
1000000100010000000000001
1000000200020000000000001
1000000100010000000001111
1000000112110000000000001
1000000000000000000001111
100000000E000000000000001
1000000000000000000000001
1111111111111111111111111
