NO ../xpm/no.xpm
SO ../xpm/so.xpm
WE ../xpm/we.xpm
EA ../xpm/ea.xpm

F 220,100,100
C 225,30,0

        1111111111111111111111111
        1000001000110000000000001
        1011000001110000000000001
        1001000000000000000000001
111111111011000001110000000000001
100000000011000001110111111111111
1100000000000N00000000000000011111111
111111111111111111111111111111111
