NO ../xpm/no_test.xpm
SO ../xpm/so_test.xpm
WE ../xpm/we_test.xpm
EA ../xpm/ea_test.xpm

F 220,100,100
C 225,30,0

        1111111111111111111111111
        1000000000110000000000001
        1011000001110000000000001
        1001000000000000000000001
111111111011000001110000000000001
100000000011000001110111111111111
111111111111111111111111111111111
